

NO ./path_to_the_north_texture
WE          ./path_to_the_west_texture

F 220,100,0
EA    ./path_to_the_east_texture

C      225,30,0




SO ./path_to_the_south_texture

1111   111111111111111111111111    1111
1001   1W00000000000000000000001  1001
1001111100111110111111111111110011001
10000000001   1001            100001
10011111001   100111           1001
1001   1001   1001             1001
1001   1001   1001111111       1001
1001   1001   1000000001       1001
1111   1111   1111111111       1111
