

WE ./path_to_the_west_texture

NO ./path_to_the_north_texture
F 220,100,0
EA ./path_to_the_east_texture


SO ./path_to_the_south_texture
C 225,30,0





1111111111111111111111111
100000000N000000000000001
1000000000110000001111111
111111111111111111
1111111       1111